3 1 1 1 1 1 1 1 1 1 
0 0 0 0 0 0 0 0 0 1 
1 1 1 1 5 5 5 5 5 1 
1 1 1 1 5 5 5 5 5 1 
7 0 0 1 5 5 5 5 5 1 
1 1 0 1 5 5 5 5 5 1 
1 1 0 1 5 5 5 5 5 1 
9 0 0 1 1 1 1 1 1 1 
1 1 0 0 7 0 0 0 8 0 
1 1 0 1 1 1 0 1 1 1 
1 0 1 0 5 5 5 0 1 3 
1 0 1 0 5 5 5 0 1 1 
1 6 1 0 5 5 5 0 1 1 
1 0 1 0 5 5 5 0 1 1 
0 0 1 0 0 0 0 0 8 0 
1 1 1 1 1 1 1 1 1 1 
0 0 0 0 0 0 0 0 7 0 
0 1 1 1 1 1 1 1 1 0 
0 1 0 7 0 0 0 0 0 0 
0 1 0 1 1 1 1 1 2 0         
3 1 1 1 0 1 0 1 1 1 
0 0 0 1 1 1 0 0 0 8 
1 1 0 1 0 1 1 1 1 1 
0 8 0 1 0 1 0 0 0 1 
1 1 1 1 1 1 1 1 1 1 
0 7 0 1 0 1 0 0 0 1 
0 1 0 1 0 1 0 0 0 1 
1 1 0 1 1 1 1 1 0 1 
1 1 0 4 4 4 4 4 0 1 
1 1 0 4 4 4 4 4 0 2          
1 1 0 1 3 1 0 0 0 0 
1 1 0 1 1 1 0 1 1 1 
1 1 0 0 8 0 0 1 0 1 
9 0 0 1 1 1 0 1 0 1 
1 1 0 0 0 1 0 1 0 1 
0 1 1 1 1 1 0 1 0 1 
0 0 0 0 0 1 1 1 0 1 
1 1 1 1 0 0 7 0 0 1 
0 0 0 1 0 1 1 1 0 1 
2 1 1 1 8 1 1 1 0 1             
1 1 0 1 1 1 0 1 1 2 
1 1 0 1 1 1 0 1 1 1 
1 1 0 1 1 1 0 1 1 1 
6 0 0 0 6 0 0 0 6 0 
1 1 1 1 1 1 1 1 1 1  
1 5 5 5 5 5 5 5 5 5 
1 1 1 1 1 1 1 1 1 1 
0 0 9 0 0 0 9 0 0 9 
0 1 1 1 0 1 1 1 0 1 
0 1 1 1 0 1 1 1 0 3             
4 4 4 4 4 4 4 4 4 4 
4 1 1 7 1 0 1 1 1 4 
4 1 1 0 1 0 1 1 1 4 
4 1 0 0 1 0 0 0 8 4 
4 1 1 0 1 1 1 1 1 4 
4 1 1 0 1 0 0 0 0 4 
4 9 0 0 1 1 1 1 1 1 
4 1 1 0 0 8 0 0 0 1 
4 3 1 0 1 1 1 0 2 1 
4 4 4 4 4 4 4 4 4 4            
1 1 1 1 1 1 1 1 1 3 
1 0 0 0 0 0 0 0 0 0 
1 8 1 0 1 0 1 0 1 0 
1 0 1 0 1 0 1 0 1 0 
1 0 1 0 1 0 1 0 1 0 
1 0 0 0 1 0 1 0 1 0 
1 1 1 8 1 1 1 1 1 0 
1 4 4 4 4 4 1 1 1 0 
1 4 4 4 4 4 1 1 1 0 
1 4 4 4 4 4 2 1 1 0
3 1 1 1 1 1 1 1 1 1 
0 0 8 0 0 0 0 0 8 0 
1 1 1 1 1 0 1 1 1 1 
0 1 0 0 1 0 1 0 0 1 
0 1 0 0 1 0 0 0 0 1 
0 1 0 0 1 8 1 1 1 1 
0 1 0 0 1 0 0 0 0 0 
0 9 0 0 1 1 1 1 1 1 
1 1 1 0 0 1 0 0 0 8 
2 1 1 0 1 1 1 0 1 1              
1 1 1 0 2 1 1 0 1 1 
1 1 1 0 1 1 1 0 1 1 
1 1 1 0 1 1 1 0 1 1 
6 0 0 0 0 8 0 0 0 7 
1 1 1 1 1 1 1 1 1 1 
1 0 0 0 0 0 0 0 0 0 
1 1 1 1 1 1 1 1 1 1 
1 0 0 8 0 0 0 8 0 0 
1 0 1 1 1 0 1 1 1 0 
3 0 1 1 1 0 1 1 1 0              
2 1 9 1 1 1 7 1 1 1 
1 1 0 1 1 1 0 1 1 1 
1 1 0 1 1 1 0 1 1 1 
4 4 4 4 4 4 4 4 4 8 
1 1 1 1 1 1 1 1 1 1 
1 5 5 5 5 5 5 5 5 5 
1 1 1 1 1 1 1 1 1 1 
4 4 4 4 4 4 4 4 4 7 
4 4 4 4 4 4 4 4 4 1 
4 4 4 4 4 4 4 4 4 1 